SO textures/2.xpm

F 15  ,90 , 25

C 10,40,255
 
NO textures/0.xpm

EA textures/1.xpm
WE            textures/3.xpm

1111111111111111111111111111111111111111
1000000000000000000000000000000000000001
1000000000000000000000000001111000100001
100111101111111111101111111    111111001
1001000000000000000000000001111000001001
1001011111111001111111111111111111001001
1001011111111001111111111111111111001001
10010110000000000000000000000000001001001
1001011011111111111110011111111101001001
1001011011111111111110011111111101001001
1001011011000000000000000000001101001001
1001011011000001111111111111101101001001
1001011011010000000000000000101101001001
1001011011010000000000000000101101001001
11000000000000010010110110000000000001001
1000000000000000010110000000000000000001
1000000000000000N10110000000000000000001
1111111111111111111111111111111111111111

